0                                                                                                                                                                                                                                                                                                                                                                        0
0                                                                                                                                                                                                                                                                                                                                                                        0
0                                                                                                                                                                                                                                                                                                                                                                        0
0                                                                                                                                                                                                                                                                                                                                                                        0
0                                                                                                                                                                                                                                                                                                                                                                        0
0                                                                                                                                                                                                                                                                                                                                                                        0
0                                                                                                                                                                                                                                                                                                                                                                        0
0                                                                                                                                                                                                                                                                                                                                                                        0
0                                                                                                                                                                                                                                                                                                                                                                        0
0                                                                                                                                                                                                                                                                                                                                                                        0
0                                                                                                                                                                                                                                                                                                                                                                        0
0                                                                                                                                                                                                                                                                                                                                                                        0
0                                                                                                                                                                                                                                                                                                                                                                        0
0                                                                                                                                                                                                                                                                                                                                                                        0
0                                                                                                                                                                                                                                                                                                                                                                        0
0                                                                                                                                                                                                                                                                                                                                                                        0
0                                                                                                                                                                                                                                                                                                                                                                        0
0                                                                                                                                                                                                                                                                                                                                                                        0
0                                                                                                                                                                                                                                                                                                                                                                        0
0                                                                                                                                                                                                                                                                                                                                                                        0
0                                                                                                                                                                                                                                                                                                                                                                        0
0                                                                                                                                                                                                                                                                                                                                                                        0
0                                                                                                                                                                                                                                                                                                                                                                        0
0                                                                                                                                                                                                                                                                                                                                                                        0
0                                                                                                                                                                                                                                                                                                                                                                        0
0                                                                                                                                                                                                                                                                                                                                                                        0
0                                                                                                                                                                                                                                                                                                                                                                        0
0                                                                                                                                                                                                                                                                                                                                                                        0
0                                                                                                                                                                                                                                                                                                                                                                        0
0                                                                                                                                                                                                                                                                                                                                                                        0
0                                                                                                                                                                                                                                                                                                                                                                        0
0                                                                                                                                                                                                                                                                                                                                                                        0
0                                                                                                                                                                                                                                                                                                                                                                        0
0                                                                                                                                                                                                                                                                                                                                                                        0
0                                                                                                                                                                                                                                                                                                                                                                        0
0                                                                                                                                                                                                                                                                                                                                                                        0
0                                                                                                                                                                                                                                                                                                                                                                        0
0                                                                                                                                                                                                                                                                                                                                                                        0
0                                                                                                                                                                                                                                                                                                                                                                        0
0                                                                                                                                                                                                                                                                                                                                                                        0
0                                                                                                                                                                                                                                                                                                                                                                        0
0                                                                                                                                                                                                                                                                                                                                                                        0
0                                                                                                                                                                                                                                                                                                                                                                        0
0                                                                                                                                                                                                                                                                                                                                                                        0
0                                                                                                                                                                                                                                                                                                                                                                        0
0                                                                                                                                                                                                                                                                                                                                                                        0
0                                                                                                                                                                                                                                                                                                                                                                        0
0                                                                                                                                                                                                                                                                                                                                                                        0
0                                                                                                                                                                                                                                                                                                                                                                        0
0                                                                                                                                                                                                                                                                                                                                                                        0
0                                                                                                                                                                                                                                                                                                                                                                        0
0                                                                                                                                                                                                                                                                                                                                                                        0
0                                                                                                                                                                                                                                                                                                                                                                        0
0                                                                                                                                                                                                                                                                                                                                                                        0
0                                                                                                                                                                                                                                                                                                                                                                        0
0                                                                                                                                                                                                                                                                                                                                                                        0
0               ba                                                                                                                                                                                                                                                                                                                                                       0
0               00                  00                                                                                                                                                                                                                                                                                                                                   0
0                                   00                                                                                                                                                                                                                                                                                                                                   0
0                                   00                aaaaaaaaaaaaaaaaaaaaaaaaaaaaaaaaaaaaaaaaaaaaaaaaaaaaaaaaaaaaaaaaaaaaaaaaaaaaaaaaaaaaaaaaaaaaaaaaaaaaaaaaaaaaaaaaaaaaaaaaaaaaaaaaaaaaaaaaaaaaaaaaaaaaaaaaaaaaaaaaaaaaaaaaaaaaaaaaaaaaaaaaaaa                                                                                                                        0
0      a              baaaa                                                                                                                                                                                                                                                                                                                                              0
0      0        ba    00000                                                                                                                                                                                                                                                                                                                                              0
0aaaaaa0aaaaaaaa00aaaa00000aaaaaaaaaaaaaaaaaaaaaaaaaaaaaaaaaaaaaaaaaaaaaaaaaaaaaaaaaaaaaaaaaaaaaaaaaaaaaaaaaaaaaaaaaaaaaaaaaaaaaaaaaaaaaaaaaaaaaaaaaaaaaaaaaaaaaaaaaaaaaaaaaaaaaaaaaaaaaaaaaaaaaaaaaaaaaaaaaaaaaaaaaaaaaaaaaaaaaaaaaaaaaaaaaaaaaaaaaaaaaaaaaaaaaaaaaaaaaaaaaaaaaaaaaaaaaaaaaaaaaaaaaaaaaaaaaaaaaaaaaaaaaaaaaaaaaaaaaaaaaaaaaaaaaaaaaaaaaaaaaaaaaaaaaaaaaaa
00000000000000000000000000000000000000000000000000000000000000000000000000000000000000000000000000000000000000000000000000000000000000000000000000000000000000000000000000000000000000000000000000000000000000000000000000000000000000000000000000000000000000000000000000000000000000000000000000000000000000000000000000000000000000000000000000000000000000000000000000
00000000000000000000000000000000000000000000000000000000000000000000000000000000000000000000000000000000000000000000000000000000000000000000000000000000000000000000000000000000000000000000000000000000000000000000000000000000000000000000000000000000000000000000000000000000000000000000000000000000000000000000000000000000000000000000000000000000000000000000000000
00000000000000000000000000000000000000000000000000000000000000000000000000000000000000000000000000000000000000000000000000000000000000000000000000000000000000000000000000000000000000000000000000000000000000000000000000000000000000000000000000000000000000000000000000000000000000000000000000000000000000000000000000000000000000000000000000000000000000000000000000
00000000000000000000000000000000000000000000000000000000000000000000000000000000000000000000000000000000000000000000000000000000000000000000000000000000000000000000000000000000000000000000000000000000000000000000000000000000000000000000000000000000000000000000000000000000000000000000000000000000000000000000000000000000000000000000000000000000000000000000000000
00000000000000000000000000000000000000000000000000000000000000000000000000000000000000000000000000000000000000000000000000000000000000000000000000000000000000000000000000000000000000000000000000000000000000000000000000000000000000000000000000000000000000000000000000000000000000000000000000000000000000000000000000000000000000000000000000000000000000000000000000
00000000000000000000000000000000000000000000000000000000000000000000000000000000000000000000000000000000000000000000000000000000000000000000000000000000000000000000000000000000000000000000000000000000000000000000000000000000000000000000000000000000000000000000000000000000000000000000000000000000000000000000000000000000000000000000000000000000000000000000000000
00000000000000000000000000000000000000000000000000000000000000000000000000000000000000000000000000000000000000000000000000000000000000000000000000000000000000000000000000000000000000000000000000000000000000000000000000000000000000000000000000000000000000000000000000000000000000000000000000000000000000000000000000000000000000000000000000000000000000000000000000
00000000000000000000000000000000000000000000000000000000000000000000000000000000000000000000000000000000000000000000000000000000000000000000000000000000000000000000000000000000000000000000000000000000000000000000000000000000000000000000000000000000000000000000000000000000000000000000000000000000000000000000000000000000000000000000000000000000000000000000000000
00000000000000000000000000000000000000000000000000000000000000000000000000000000000000000000000000000000000000000000000000000000000000000000000000000000000000000000000000000000000000000000000000000000000000000000000000000000000000000000000000000000000000000000000000000000000000000000000000000000000000000000000000000000000000000000000000000000000000000000000000